,國文,英文,數學,地理,歷史,總分,平均
1,87,76,67,68,95,393,78.6
2,98,94,61,96,82,431,86.2
3,69,88,65,97,84,403,80.6
4,75,73,79,88,95,410,82.0
5,94,70,74,92,76,406,81.2
6,79,75,94,97,99,444,88.8
7,95,88,90,95,61,429,85.8
8,91,66,81,81,81,400,80.0
9,77,77,83,99,84,420,84.0
10,69,66,72,85,97,389,77.8
11,90,75,90,70,70,395,79.0
12,87,93,92,78,68,418,83.6
13,72,62,93,80,96,403,80.6
14,77,60,99,83,92,411,82.2
15,95,96,60,92,93,436,87.2
16,98,77,79,61,65,380,76.0
17,94,75,79,76,63,387,77.4
18,60,66,98,91,61,376,75.2
19,96,61,73,76,78,384,76.8
20,95,88,95,86,99,463,92.6
21,79,72,77,93,64,385,77.0
22,60,93,96,77,95,421,84.2
23,72,64,85,92,92,405,81.0
24,97,93,91,98,99,478,95.6
25,93,65,65,98,96,417,83.4
26,85,61,68,70,66,350,70.0
27,74,71,91,66,97,399,79.8
28,78,96,90,96,63,423,84.6
29,97,84,93,61,76,411,82.2
30,98,89,81,85,90,443,88.6
31,67,99,60,77,84,387,77.4
32,65,91,86,98,61,401,80.2
33,69,91,63,90,61,374,74.8
34,76,64,62,83,64,349,69.8
35,98,74,75,76,77,400,80.0
36,69,76,97,62,77,381,76.2
37,77,98,73,62,64,374,74.8
38,83,69,82,61,96,391,78.2
39,79,83,95,82,63,402,80.4
40,91,86,88,67,86,418,83.6
41,79,67,68,91,83,388,77.6
42,85,62,62,92,71,372,74.4
43,66,73,77,72,78,366,73.2
44,86,99,95,81,96,457,91.4
45,70,93,63,86,97,409,81.8
46,68,79,78,61,85,371,74.2
47,91,88,77,88,76,420,84.0
48,79,84,94,79,90,426,85.2
49,76,99,98,87,78,438,87.6
50,90,94,70,72,67,393,78.6
